1) PRAGMATIC : UNREALISTICA) perplexing : straightforward 
B) flirtatious : coquettish
C) opulent : rich
D) sinful : erotic
a

2) PRIEST : ORDAINEDA) lord : defrocked
B) senator : allowed
C) president : inaugurated 
D) king : graduated
c

3) NEIGHBORHOOD : CITYA) priory : monk 
B) jumper : dress 
C) iceberg : tip
D) annex : building
d

4) PICCOLO : INSTRUMENT
A) violoncello : bass
B) currency : dollar
C) decathlon : competition 
D) cult : festival
c

5) CONUNDRUM : PUZZLEA) palace : estate
B) phenomenon : science 
C) dynamite : destruction 
D) actor : choreographer
a

6) RUSE : TRICKA) hangman : condemn 
B) funeral : eliminateC) spectacle : entertain 
D) inventor : deviate
c

7) SACROSANCT : HOLYA) surprising : remarkable 
B) skeptical : gullible
C) ridiculous : absurd
D) abominable : evil
d

8) CATHEDRAL : CHURCHA) university : school
B) orchestra : symphony 
C) preamble : constitution 
D) prefix : suffix
a

9) SELFISH : ALTRUISMA) ambiguity : uncertainty 
B) hollow : emptiness
C) insidious : diseases
D) depraved : morality
d

10) LOQUACIOUS : QUIETA) forgiven : annulled 
B) trivial : crucial
C) salacious : impure 
D) enduring : ongoing
b