1) FRAIL : BRAWNA) humorous : wit
B) obtuse : intensity
C) disinterested : ennui 
D) longwinded : brevity 
E) tenuous : weakness
d

2) ACROPHOBIA : HEIGHTSA) claustrophobia : closets
B) homophobia : discrimination 
C) agoraphobia : crowds
D) vertigo : balance
E) arachnophobia : insects
c

3) HERETIC : UNORTHODOXA) hero : folksy
B) braggart : boastful
C) javelin : underhanded 
D) hiatus : eternal
E) jinx : auspicious
b

4) DEBUNK : VERIFYA) revere : denigrate
B) besmirch : slander
C) cower : submit
D) pontificate : pronounce 
E) capitulate : surrender
a

5) LEGEND : MAPA) continent : nation 
B) page : tome
C) tirade : government 
D) legion : family
E) army : soldier
b

6) EPISTLE : LETTERA) decathlon : competition 
B) multitude : feast
C) lounge : vacation
D) credo : church
E) festival : carnival
a

7) ARCHAEOLOGIST : HIEROGLYPHICSA) theologian : cancer 
B) sojourner : destiny
C) storyteller : mysteries 
D) courier : packages
E) translator : languages
e

8) THWART : FRUSTRATE
A) retain : burst
B) meditate : snooze 
C) bully : balk
D) bristle : brush
E) laud : praise
e