1) WEAK : STRENGTHA) silly : comedy 
B) wild : friends 
C) brave : courage 
D) lost : direction
d

2) HURRICANE : STORMA) table : furniture 
B) tornado : rain 
C) snow : wind
D) chair : sofa
a

3) SUIT : FORMALA) hat : attractive 
B) coat : warm
C) shoe : lonely 
D) tie : black
b

4) HUNGRY : FULL
A) salty : delicious 
B) polite : kind
C) evil : good
D) beautiful : lovely
c

5) LAP : RACEA) head : hair
B) act : play
C) runner : athlete 
D) show : theater
b

6) HAMBURGER : SANDWICHA) foot : leg 
B) cow : pigC) sport : baseball 
D) pretzel : snack
d

7) MEAT : ANIMALSA) paper : trees
B) diamonds : pearls 
C) wood : rocks
D) oranges : apples
a

8) ANGRY : MADA) awake : alone
B) depressed : confused 
C) polite : rude
D) nice : kind
d

9) COMMERCIAL : ADVERTISEA) sport : teach
B) newspaper : inspire 
C) comedy : entertain 
D) drama : annoy
c

10) VOLLEYBALL : SPORT
A) rabbit : cat
B) runner : athlete 
C) tiger : zoo
D) soccer : football
b