1) FILAMENT : LIGHTBULBA) misunderstanding : conversation 
B) blade : propeller
C) car : gearshift
D) outlet : economy
b

2) CARNIVAL : ENTERTAINMENTA) poster : propaganda
B) handout : welfare
C) encyclopedia : information 
D) statement : persuasion
c

3) INCONCEIVABLE : DOUBTFULA) healthful : beneficial 
B) credible : plausible 
C) indecent : lustful
D) sickening : repugnant
d

4) EXHAUSTING : REJUVENATING
A) disturbing : soothing 
B) cruel : ruthless
C) pitiful : miserable
D) vexing : irritating
a

5) CORPSE : DECEASEDA) infant : nascent
B) prophet : skeptical 
C) tyrant : easygoing 
D) athlete : sluggish
a

6) LAMENTATION : SORROWA) psalm : warning 
B) sonnet : religionC) eulogy : praise
D) newspaper : disapproval
c

7) MEDAL : ACCOLADEA) song : hymnal
B) cauldron : kettle 
C) fire : kindling
D) airplane : hangar
b

8) PROVISIONAL : PERMANENTA) aggressive : fierce
B) improved : enhanced 
C) undercover : covert 
D) moderate : extreme
d

9) FOOLISH : SAGACITYA) miserly : generosity 
B) tangible : fingers
C) tardy : time
D) infamous : celebrity
a

10) EUPHEMISM : INOFFENSIVE
A) charlatan : dishonest 
B) wizard : mundane
C) scorpion : harmless 
D) gymnast : clumsy
a