1) ARTICULATE : MUTEA) graceful : klutzy
B) spectacular : showy
C) ornate : elegant
D) embellished : superficial 
E) excruciating : painful
a

2) WATERWAY : NAVIGABLEA) farm : famished
B) mountain : surmountable 
C) vault : unimpressed
D) fountain : youthful
E) judge : ramshackle
b

3) SPLINTER : WOODA) skin : cellB) guitar : orchestra 
C) shard : glass
D) seed : bagel
E) glaze : pottery
c

4) CLEMENCY : FORGIVENESSA) ardor : passion
B) oblivion : repair
C) nirvana : faith
D) intoxication : sobriety 
E) digestion : cuisine
a

5) ALTERCATION : DISCUSSIONA) sermon : preacherB) judgment : mercy 
C) insult : critic
D) diatribe : speech
E) requiem : composer
d

6) GRAIN : SILOA) water : reservoir
B) fuel : ration
C) gasoline : automobile 
D) snow : igloo
E) parchment : library
a

7) ANGUISH : PAINA) lust : virtue
B) bliss : sadness
C) emptiness : vacancy 
D) similarity : relationship 
E) longing : desire
e

8) PREDICTABLE : SPONTANEITY
A) stormy : reason
B) unfeeling : sympathy 
C) capricious : will
D) dreamy : rest
E) unafraid : shame
b