1) SENATE : CONGRESSA) cinema : theater
B) lobby : hotel
C) judge : chamber
D) government : democracy
b

2) SUCCESS : FAILUREA) grief : sadness 
B) debt : loss
C) virtue : evil
D) life : birth
c

3) HEINOUS : EVILA) tremendous : large 
B) old : antique
C) distressed : flawed 
D) possible : probable
a

4) SCRIBE : WRITE
A) mother : reign
B) tribute : offend
C) translator : read 
D) watchman : guard
d

5) GLASS : DELICATEA) air : bearable 
B) stone : gray
C) cola : bubbly 
D) peace : eternal
c

6) CAT : FELINEA) book : novel
B) blunder : mistakeC) theatre : play
D) automobile : tank
b

7) HOBBY : PASTIMEA) emperor : leader 
B) producer : product 
C) skill : sport
D) player : athlete
a

8) AMBITIOUS : LAZYA) embarrassed : timid 
B) talkative : loud
C) friendly : gregarious 
D) insecure : confident
d

9) CAREFREE : WORRIESA) hesitant : doubt
B) ignorant : knowledge 
C) pleasing : happiness 
D) lovely : affection
b

10) MASTER : DOMINANT
A) nation : powerful
B) activist : naive
C) worker : impoverished 
D) ghost : ethereal
d