1) SLAVE : SUBMISSIVEA) murderer : violent 
B) circus : laughable 
C) professor : ignorant 
D) professional : bossy
a

2) PIPE : WATERA) bottle : wine 
B) artery : paint 
C) vein : blood 
D) nozzle : hose
c

3) DREAMER : IDEALISTICA) judge : legal
B) cynic : critical
C) parent : feminine 
D) novice : skilled
b

4) VERDICT : JUDGMENT
A) jet : helicopter
B) observation : science 
C) principal : school
D) infant : baby
d

5) CRUEL : UNKINDA) graceful : flexible 
B) vicious : aggressive 
C) frightening : spooky 
D) evil : insane
b

6) SQUARE : QUADRILATERALA) rifle : weapon
B) instrument : violinC) pattern : plaid
D) airplane : spacecraft
a

7) CLUMSY : GRACEA) doubtful : faith
B) determined : work 
C) rich : charity
D) beautiful : love
a

8) PERMANENT : TEMPORARYA) ordinary : plain
B) imaginary : fake
C) astonishing : surprising 
D) skeptical : trusting
d

9) ATTORNEY : LAWYERA) worker : secretary 
B) flower : daffodil 
C) dog : canine
D) doctor : dentist
c

10) RAIN : PRECIPITATION
A) salmon : seafood 
B) snow : tundra
C) jungle : desert 
D) pet : hamster
a