1) PANACEA : CUREA) cello : compose
B) stereo : listen
C) contagion : infect 
D) stopwatch : hasten
c

2) DENOUEMENT : PLOTA) appetizer : meal
B) gown : ball
C) rifle : dagger
D) libertarian : revolution
a

3) LABYRINTH : COMPLICATEDA) tempo : upbeat
B) enigma : mysterious 
C) narrator : biased
D) legend : credible
b

4) LIVID : ANGRY
A) trim : anorexic
B) contrary : contrite
C) faithful : dogmatic
D) crestfallen : depressed
d

5) ALOOF : CONNECTEDA) deliberate : accidental 
B) rigid : firm
C) ethereal : fleeting
D) logical : calculating
a

6) NEUTRAL : INDIFFERENTA) exotic : commonplace 
B) lazy : indolentC) finicky : relaxed
D) unsettling : detached
b

7) MALLET : STRIKEA) harpsichord : twinkle 
B) impression : paint
C) ornament : embellish 
D) ottoman : weave
c

8) PLAGIARISM : WRONGDOINGA) citrus : lemonade 
B) infection : bacteria 
C) crime : punishment 
D) cancer : malady
d

9) BLATANT : INCONSPICUOUSA) tedious : engaging
B) restorative : peaceful 
C) indulgent : luxurious 
D) pedantic : ordinary
a

10) OBJECTIVE : BIAS
A) fallacious : lies
B) autistic : health
C) tentative : certainty 
D) awake : insomnia
c