1) MOUNTAIN : HIGHA) river : ugly
B) valley : low 
C) forest : lonely 
D) desert : wet
b

2) TEACHER : EDUCATEA) senator : represent 
B) lawyer : instruct
C) coach : condemn 
D) priest : annoy
a

3) GOLD : EXPENSIVEA) jewelry : dull
B) cotton : beautiful 
C) silver : outrageous 
D) velvet : soft
d

4) MOTHER : FEMALE
A) vegetable : green 
B) snake : dangerous 
C) rock : hard
D) tree : old
c

5) INFURIATING : ANNOYINGA) ruined : ugly
B) devastated : sad
C) depressed : intelligent 
D) arrogant : clever
b

6) HELICOPTER : SKYA) canoe : street 
B) truck : riverC) motorcycle : bus 
D) submarine : water
d

7) UNKNOWN : FAMEA) rapid : speed
B) ignorant : education 
C) refined : manners 
D) lovely : sight
b

8) NICE : UNKINDA) hideous : pretty 
B) safe : solid
C) loud : noisy
D) terrible : awful
a

9) TELEVISION : WATCHEDA) record : baked
B) newspaper : cooked 
C) novel : read
D) comic : laughed
c

10) PIE : DESSERTA) bacon : meat 
B) candy : drink 
C) cola : tea
D) ham : beef
a