1) ENIGMA : MYSTERIOUSA) bigot : prejudiced 
B) beetle : venomous 
C) politician : obtuse 
D) professor : glib
E) potion : potent
a

2) VEIL : ENSHROUDA) beautician : paint 
B) lampoon : mock 
C) laureate : preside 
D) flare : locate
E) lantern : identify
b

3) POISON : NOXIOUSA) performance : stellarB) satellite : worldly
C) maze : labyrinthine 
D) wavelength : shallow 
E) leather : worn
c

4) PLACID : TUMULTUOUSA) coveted : desired
B) reviled : despised
C) tangential : irrelevant
D) credible : dubious
E) unconventional : irregular
d

5) BLATANT : OBVIOUSA) obscure : marredB) legendary : unbelievable 
C) novel : obsolete
D) powerful : dominant
E) preeminent : important
e

6) BLASPHEMY : RELIGIONA) fornication : marriage 
B) treason : state
C) lethargy : energy
D) avarice : currency
E) apathy : motivation
b

7) TAWDRY : TASTEA) vicious : wrath
B) bourgeois : wealth
C) haughty : humility
D) paraplegic : legs
E) misshapen : deformity
c

8) TEDIUM : EXCITEMENT
A) revision : edition
B) honor : prestige
C) mortgage : debt
D) acceptance : denial
E) perturbation : frustration
d