great	good
beautiful	pretty
ring	finger
correct	right
shoe	foot
puppy	dog
rock	hard
sick	health
hammer	hit
shield	protect
musician	music
whale	ocean
terrified	scared
sad	happiness
tongue	taste
chair	sit
wrench	tool
tiny	little
poor	money
safe	dangerous
wall	room
match	fire
candy	sweet
huge	big
teacher	educate
ugly	beauty
hilarious	funny
play	work
eyes	see
ham	meat
mountain	high
teacher	educate
gold	expensive
mother	female
infuriating	annoying
helicopter	sky
unknown	fame
nice	unkind
television	watched
pie	dessert
second	minute
author	write
wonderful	good
broken	repaired
knife	sharp
boots	feet
zebra	animal
obvious	hidden
evil	morals
racist	prejudiced
weak	strength
hurricane	storm
suit	formal
hungry	full
lap	race
hamburger	sandwich
meat	animals
angry	mad
commercial	advertise
volleyball	sport
athlete	fit
microwave	heat
comedy	funny
brother	sibling
humiliated	embarrassed
train	railroad
skeptical	belief
optimism	pesimissm
sunscreen	skin
spaghetti	pasta
liar	honesty
downpour	rain
wizard	magical
misfortune	luck
verse	song
almond	nut
wool	sheep
pebble	stone
newspaper	inform
bus	automobile
engine	car
butcher	meat
obscene	inappropriate
positive	negative
cigarette	unhealthy
helmet	head
sewing	craft
accident	unintended
trivial	importance
expert	skilled
corrupt	morals
democracy	government
cowardly	brave
knight	chivalrous
buckle	belt
blizzard	storm
carnivore	meat
honest	sincere
academy	educate
rectangle	shape
senate	congress
success	failure
heinous	evil
scribe	write
glass	delicate
cat	feline
hobby	pastime
ambitious	lazy
carefree	worries
master	dominant
slave	submissive
pipe	water
dreamer	idealistic
verdict	judgment
cruel	unkind
square	quadrilateral
clumsy	grace
permanent	temporary
attorney	lawyer
rain	precipitation
conclusion	essay
locker	storage
excruciating	painful
fame	obscurity
heirloom	inherited
sunscreen	sunburn
aluminum	metal
active	idle
hasty	patience
klutz	clumsy
epidemic	widespread
note	melody
lifejacket	boat
devout	religious
hidden	visible
cough	cold
veins	circulate
assassination	murder
ignite	extinguish
elderly	youth
honor	disgrace
whisper	quiet
island	archipelago
patience	virtue
kiss	affection
network	connect
devastated	damaged
algebra	mathematics
uninhibited	restraint
offer	request
panacea	cure
denouement	plot
labyrinth	complicated
livid	angry
aloof	connected
neutral	indifferent
mallet	strike
plagiarism	wrongdoing
blatant	inconspicuous
objective	bias
pragmatic	unrealistic
priest	ordained
neighborhood	city
piccolo	instrument
conundrum	puzzle
ruse	trick
sacrosanct	holy
cathedral	church
selfish	altruism
loquacious	quiet
filament	lightbulb
carnival	entertainment
inconceivable	doubtful
exhausting	rejuvenating
corpse	deceased
lamentation	sorrow
medal	accolade
provisional	permanent
foolish	sagacity
euphemism	inoffensive
anarchist	government
propaganda	opinion
couch	furniture
surreptitious	obvious
finale	musical
listen	eavesdrop
glutton	moderation
winery	merlot
articulate	mute
waterway	navigable
splinter	wood
clemency	forgiveness
altercation	discussion
grain	silo
anguish	pain
predictable	spontaneity
hidden	covert
cat	shed
bluff	intentions
sharp	blunt
game	spectators
arid	moisture
pain	sensation
bohemian	unconventional
buttress	wall
jury	deliberate
saccharine	sweet
altruism	selfishness
bishop	ordained
pragmatic	practical
cauldron	pot
precept	guidance
frail	brawn
acrophobia	heights
heretic	unorthodox
debunk	verify
legend	map
epistle	letter
archaeologist	hieroglyphics
thwart	frustrate
enigma	mysterious
veil	enshroud
poison	noxious
placid	tumultuous
blatant	obvious
blasphemy	religion
tawdry	taste
tedium	excitement
powerless	efficacy
rivulet	small
wretched	cheerful
level	hierarchy
peccadillo	sin
tyro	inexperienced
blandishment	coax
pragmatism	philosophy
element	aggregate
decanter	pour
unprecedented	forerunners
erudite	uneducated
truism	obvious
laconic	concise
lie	prevaricate
concession	placate
vitriol	bitter
invective	blame
vernacular	regional
virulent	poisonous
grenadier	army
fake	authenticity
nefarious	virtuous
castigate	criticize
fun	cool
strange	weird
hot	warm
dull	sharp
terrible	bad
brave	valiant
new	old
tall	skinny
necklace	neck
bracelet	diamond
sock	hand
glove	foot
crazy	smart
weak	fun
strong	hard
cheap	inexpensive
boot	hand
glove	wrist
hat	head
sock	leg
kitten	cat
bear	cub
fish	minnow
cow	calf
water	wet
table	wooden
mom	nice
sound	loud
sad	emotion
tall	intelligence
scared	courage
smart	energy
knife	cut
table	eat
pen	build
wheel	race
computer	talk
vehicle	transport
pencil	make
song	sing
shower	water
chef	food
machine	snow
child	art
car	garage
tiger	jungle
chair	table
quiet	secret
sweet	rich
obsessed	interested
funny	serious
weak	strength
sweet	flavor
fast	time
pretty	beauty
boat	swim
bed	sit
bag	buy
nose	smell
cup	drink
bottle	break
book	read
eye	listen
cow	milk
radio	sound
tree	forest
carrot	vegetable
huge	big
long	tall
small	loud
neat	messy
tired	energy
angry	emotion
hot	ice
hungry	water
silent	noisy
upset	late
wise	smart
fast	quick
lettuce	sandwich
dog	cat
wheel	car
song	dance
bag	wallet
key	car
gas	machine
cookie	mouth
water	cold
time	fast
money	expensive
fire	hot
nice	good
tiny	small
funny	happy
old	new
doctor	heal
farmer	talk
engine	oil
dog	sit
serious	humor
old	age
hot	heat
sweet	strength
right	wrong
hard	boring
nice	crazy
great	good
laugh	cry
eat	talk
run	walk
see	hear
hands	cry
ears	hear
feet	talk
teeth	think
air	water
tennis	school
juice	drink
math	number
river	ugly
valley	low
forest	lonely
desert	wet
senator	represent
lawyer	instruct
coach	condemn
priest	annoy
jewelry	dull
cotton	beautiful
silver	outrageous
velvet	soft
vegetable	green
snake	dangerous
rock	hard
tree	old
ruined	ugly
devastated	sad
depressed	intelligent
arrogant	clever
canoe	street
truck	river
motorcycle	bus
submarine	water
rapid	speed
ignorant	education
refined	manners
lovely	sight
hideous	pretty
safe	solid
loud	noisy
terrible	awful
record	baked
newspaper	cooked
novel	read
comic	laughed
bacon	meat
candy	drink
cola	tea
ham	beef
day	week
centimeter	inch
mile	hour
year	month
mother	annoy
banker	preach
firefighter	study
janitor	clean
great	terrific
sinful	evil
terrifying	scary
perfect	flawed
foreign	strange
selfish	generous
unusual	weird
nasty	mean
crime	illegal
child	rude
wife	powerful
war	peaceful
socks	underwear
shorts	pants
mittens	hands
braces	glasses
green	color
shape	cube
country	Brazil
food	dessert
silver	jewelry
dress	gown
idea	belief
liberal	conservative
special	manners
famous	friends
blind	sight
beautiful	opinions
saint	holy
worker	tired
nurse	sick
clerk	hungry
silly	comedy
wild	friends
brave	courage
lost	direction
table	furniture
tornado	rain
snow	wind
chair	sofa
hat	attractive
coat	warm
shoe	lonely
tie	black
salty	delicious
polite	kind
evil	good
beautiful	lovely
head	hair
act	play
runner	athlete
show	theater
foot	leg
cow	pig
sport	baseball
pretzel	snack
paper	trees
diamonds	pearls
wood	rocks
oranges	apples
awake	alone
depressed	confused
polite	rude
nice	kind
sport	teach
newspaper	inspire
comedy	entertain
drama	annoy
rabbit	cat
runner	athlete
tiger	zoo
soccer	football
chef	fat
dog	energetic
priest	religious
dancer	intelligent
refrigerator	cool
freezer	cook
sink	organize
fireplace	destroy
mystery	boring
drama	romantic
tragedy	sad
newspaper	expensive
mother	daughter
doctor	nurse
uncle	aunt
father	parent
shy	timid
enraged	angry
sad	upset
excited	anxious
boat	mountain
helicopter	cloud
truck	highway
wagon	wheel
unpopular	wealth
homeless	shelter
polite	power
nervous	stress
success	failure
food	hunger
motivation	dedication
maturity	youth
magic	children
grass	house
armor	body
faith	country
ketchup	condiment
lettuce	sauce
bacon	fruit
cereal	dairy
lawyer	mercy
mother	children
fool	wisdom
soldier	power
wave	water
tornado	clouds
blizzard	snow
desert	heat
king	royal
nun	silent
teacher	ordinary
chef	delicious
victory	defeat
coffee	tea
life	birth
sugar	salt
core	apple
mop	broom
supermarket	office
coat	jacket
hill	mountain
helicopter	aircraft
sport	football
lamp	lightbulb
leather	cows
metal	trees
paper	rocks
wood	mountains
minnow	fish
car	truck
tiger	lion
dictionary	book
television	watch
book	communicate
movie	persuade
game	entertain
building	house
tiger	animal
letter	alphabet
bath	shower
lens	microscope
day	night
picture	frame
club	member
maid	chores
teacher	knowledge
librarian	books
baker	bread
impossible	easy
polite	rude
tall	honest
spotless	clean
clean	filthy
angry	upset
friendly	popular
challenging	interesting
sin	immoral
baby	wise
husband	rich
nation	peaceful
mask	face
belt	train
ring	wrist
slipper	ankle
salt	food
fate	science
gasoline	fuel
sunrise	art
idea	true
law	perfect
villain	evil
castle	unknown
prestigious	honor
written	rhyme
invisible	sight
familiar	novelty
athlete	thin
student	intelligent
spy	friendly
fanatic	enthusiastic
talented	skill
rude	intelligence
fortunate	money
ruthless	mercy
master	slave
storm	blizzard
sonnet	poem
tribe	family
numerous	many
foolish	wise
awful	dreadful
anxious	nervous
flower	fragrant
daughter	rebellious
conversation	short
disease	curable
suit	tie
shovel	pit
summer	season
month	year
novelist	writer
boat	submarine
radio	television
organization	party
vegetarian	wheat
herbivore	plants
omnivore	food
vegan	pastries
solitary	alone
peaceful	nervous
vengeful	forgiving
religious	doubtful
court	blame
trailer	roam
jail	imprison
cafe	ingest
dealer	employer
deer	antelope
telephone	call
assault	crime
cinema	theater
lobby	hotel
judge	chamber
government	democracy
grief	sadness
debt	loss
virtue	evil
life	birth
tremendous	large
old	antique
distressed	flawed
possible	probable
mother	reign
tribute	offend
translator	read
watchman	guard
air	bearable
stone	gray
cola	bubbly
peace	eternal
book	novel
blunder	mistake
theatre	play
automobile	tank
emperor	leader
producer	product
skill	sport
player	athlete
embarrassed	timid
talkative	loud
friendly	gregarious
insecure	confident
hesitant	doubt
ignorant	knowledge
pleasing	happiness
lovely	affection
nation	powerful
activist	naive
worker	impoverished
ghost	ethereal
murderer	violent
circus	laughable
professor	ignorant
professional	bossy
bottle	wine
artery	paint
vein	blood
nozzle	hose
judge	legal
cynic	critical
parent	feminine
novice	skilled
jet	helicopter
observation	science
principal	school
infant	baby
graceful	flexible
vicious	aggressive
frightening	spooky
evil	insane
rifle	weapon
instrument	violin
pattern	plaid
airplane	spacecraft
doubtful	faith
determined	work
rich	charity
beautiful	love
ordinary	plain
imaginary	fake
astonishing	surprising
skeptical	trusting
worker	secretary
flower	daffodil
dog	canine
doctor	dentist
salmon	seafood
snow	tundra
jungle	desert
pet	hamster
theme	song
meal	dessert
parade	party
scene	play
telephone	communication
wallet	cash
pencil	paper
lake	moisture
baffling	confusing
upsetting	exciting
improving	hopeful
crippling	stressful
peace	harmony
music	art
knowledge	wisdom
sorrow	joy
ship	wooden
sermon	religious
newspaper	popular
coupon	valuable
hope	tornado
vaccination	disease
carelessness	accident
dream	sleep
limerick	poetry
mathematics	numbers
rain	season
water	thirst
challenging	difficult
dramatic	tragic
brief	lengthy
scholarly	studious
unskilled	magic
terrified	logic
unqualified	credentials
gullible	belief
priest	evil
cold	contagious
car	broken
vegetable	green
artist	idealistic
island	lonesome
emergency	urgent
intention	challenged
bone	skeleton
movie	film
meal	restaurant
career	job
medicine	disease
seatbelt	plane
shield	sword
hat	helmet
hyper	energetic
depressed	angry
fit	strong
cruel	strange
spicy	delicious
flimsy	sturdy
tasteful	classy
elevated	escalated
fever	issue
problem	solution
disagreement	argument
room	hotel
calculators	think
boots	sprint
laws	enforce
ornaments	decorate
document	certificate
beverage	drink
relay	race
technology	robot
harvest	plant
rest	relax
investigate	trust
remove	confiscate
famous	popularity
rational	proof
smug	satisfaction
well	illness
comfort	pleasure
safety	peril
sanity	sense
anger	rage
folktale	traditional
whip	evil
disease	curable
meal	satisfying
anchor	aircraft
archive	album
ocean	iceberg
article	newspaper
essay	story
currency	credit
denial	reaction
faith	religion
smile	fear
joke	importance
message	information
television	actors
statue	memorialize
funeral	eliminate
telephone	hear
device	create
unusual	weird
unkind	hurtful
incredible	mundane
prevalent	common
rain	precipitation
bronze	metal
tradition	culture
trade	economy
overweight	shape
unhealthy	control
intelligent	thought
generous	selfishness
damage	repair
enjoy	entertain
experience	participate
endure	continue
cello	compose
stereo	listen
contagion	infect
stopwatch	hasten
appetizer	meal
gown	ball
rifle	dagger
libertarian	revolution
tempo	upbeat
enigma	mysterious
narrator	biased
legend	credible
trim	anorexic
contrary	contrite
faithful	dogmatic
crestfallen	depressed
deliberate	accidental
rigid	firm
ethereal	fleeting
logical	calculating
exotic	commonplace
lazy	indolent
finicky	relaxed
unsettling	detached
harpsichord	twinkle
impression	paint
ornament	embellish
ottoman	weave
citrus	lemonade
infection	bacteria
crime	punishment
cancer	malady
tedious	engaging
restorative	peaceful
indulgent	luxurious
pedantic	ordinary
fallacious	lies
autistic	health
tentative	certainty
awake	insomnia
perplexing	straightforward
flirtatious	coquettish
opulent	rich
sinful	erotic
lord	defrocked
senator	allowed
president	inaugurated
king	graduated
priory	monk
jumper	dress
iceberg	tip
annex	building
violoncello	bass
currency	dollar
decathlon	competition
cult	festival
palace	estate
phenomenon	science
dynamite	destruction
actor	choreographer
hangman	condemn
funeral	eliminate
spectacle	entertain
inventor	deviate
surprising	remarkable
skeptical	gullible
ridiculous	absurd
abominable	evil
university	school
orchestra	symphony
preamble	constitution
prefix	suffix
ambiguity	uncertainty
hollow	emptiness
insidious	diseases
depraved	morality
forgiven	annulled
trivial	crucial
salacious	impure
enduring	ongoing
misunderstanding	conversation
blade	propeller
car	gearshift
outlet	economy
poster	propaganda
handout	welfare
encyclopedia	information
statement	persuasion
healthful	beneficial
credible	plausible
indecent	lustful
sickening	repugnant
disturbing	soothing
cruel	ruthless
pitiful	miserable
vexing	irritating
infant	nascent
prophet	skeptical
tyrant	easygoing
athlete	sluggish
psalm	warning
sonnet	religion
eulogy	praise
newspaper	disapproval
song	hymnal
cauldron	kettle
fire	kindling
airplane	hangar
aggressive	fierce
improved	enhanced
undercover	covert
moderate	extreme
miserly	generosity
tangible	fingers
tardy	time
infamous	celebrity
charlatan	dishonest
wizard	mundane
scorpion	harmless
gymnast	clumsy
activist	diversity
feminist	men
politician	order
abolitionist	slavery
teetotaler	prohibition
sermon	morality
commercial	economy
battle	violence
diatribe	negativity
eulogy	death
bookcase	encyclopedia
knife	cutlery
bed	canopy
cinema	rental
protestor	villain
scholarly	professional
harmonious	musical
pacifying	enraging
sponsored	bribed
artistic	masterful
inning	baseball
stitch	tapestry
mystery	novel
barista	coffee
homestretch	race
grin	smile
donate	relinquish
assume	conclude
prognosticate	guess
move	sneak
braggart	humility
professor	knowledge
sage	wisdom
lawyer	prudence
caretaker	affection
supermarket	espresso
marathon	water
cafe	whiskey
brewery	beer
grove	applesauce
graceful	klutzy
spectacular	showy
ornate	elegant
embellished	superficial
excruciating	painful
farm	famished
mountain	surmountable
vault	unimpressed
fountain	youthful
judge	ramshackle
skin	cell
guitar	orchestra
shard	glass
seed	bagel
glaze	pottery
ardor	passion
oblivion	repair
nirvana	faith
intoxication	sobriety
digestion	cuisine
sermon	preacher
judgment	mercy
insult	critic
diatribe	speech
requiem	composer
water	reservoir
fuel	ration
gasoline	automobile
snow	igloo
parchment	library
lust	virtue
bliss	sadness
emptiness	vacancy
similarity	relationship
longing	desire
stormy	reason
unfeeling	sympathy
capricious	will
dreamy	rest
unafraid	shame
diverse	ordinary
angry	judgmental
feminine	ladylike
hardworking	dull
prohibited	allowed
bird	molt
elephant	hunt
dog	fetch
ferret	burrow
human	tattoo
cloak	mask
disguise	appearance
backpack	computer
envelope	messenger
prayer	faith
studious	intelligent
impermanent	temporary
philosophical	religious
forgiving	harsh
translated	interpreted
theater	actors
opera	audience
diner	waitresses
museum	dinosaurs
school	pupils
vacant	emptiness
prophetic	vision
stoic	emotion
crystal	clarity
salty	sodium
knowledge	mathematics
resonance	music
pork	meatloaf
judgment	court
excitement	emotion
pariah	unpopular
fairy	ephemeral
symphony	cacophonous
masterpiece	novel
libertine	chaste
precinct	city
column	pillar
cream	lotion
document	preamble
philanthropist	charity
candidate	deprecate
precedent	preside
ruse	illuminate
lobbyist	persuade
parachute	open
omniscient	omnipotent
lethargic	slovenly
sacrosanct	sacred
hypocritical	dissonant
obtuse	angular
alacrity	clarity
passion	fervor
levity	flippancy
gravity	momentum
impartiality	bias
palace	stately
transgression	acceptable
cliche	intrepid
loft	unattainable
character	humorous
irritating	pleasing
tenacious	faltering
opaque	translucent
trivial	negligible
unusual	ludicrous
vibration	perception
pictograph	symbol
favor	currency
luminary	phantasm
paragon	light
chord	music
footnote	connotation
mathematician	numbers
epilogue	introduction
alibi	defense
humorous	wit
obtuse	intensity
disinterested	ennui
longwinded	brevity
tenuous	weakness
claustrophobia	closets
homophobia	discrimination
agoraphobia	crowds
vertigo	balance
arachnophobia	insects
hero	folksy
braggart	boastful
javelin	underhanded
hiatus	eternal
jinx	auspicious
revere	denigrate
besmirch	slander
cower	submit
pontificate	pronounce
capitulate	surrender
continent	nation
page	tome
tirade	government
legion	family
army	soldier
decathlon	competition
multitude	feast
lounge	vacation
credo	church
festival	carnival
theologian	cancer
sojourner	destiny
storyteller	mysteries
courier	packages
translator	languages
retain	burst
meditate	snooze
bully	balk
bristle	brush
laud	praise
bigot	prejudiced
beetle	venomous
politician	obtuse
professor	glib
potion	potent
beautician	paint
lampoon	mock
laureate	preside
flare	locate
lantern	identify
performance	stellar
satellite	worldly
maze	labyrinthine
wavelength	shallow
leather	worn
coveted	desired
reviled	despised
tangential	irrelevant
credible	dubious
unconventional	irregular
obscure	marred
legendary	unbelievable
novel	obsolete
powerful	dominant
preeminent	important
fornication	marriage
treason	state
lethargy	energy
avarice	currency
apathy	motivation
vicious	wrath
bourgeois	wealth
haughty	humility
paraplegic	legs
misshapen	deformity
revision	edition
honor	prestige
mortgage	debt
acceptance	denial
perturbation	frustration
turbulent	violence
anomalous	irregularity
homogenous	similarity
effluent	water
explicit	ambiguity
dissertation	plagiarized
bird	fledgling
bankruptcy	indebted
hooligan	athletic
citadel	fortified
territorial	terrestrial
innocuous	dangerous
floundering	struggling
redacted	censored
solitary	confined
installment	serial
halo	messiah
vinaigrette	salad
courtroom	drama
misnomer	definition
masquerade	party
peasant	serf
sarcophagus	funeral
letdown	devastation
hex	wizard
headmaster	principled
scapegoat	blameworthy
forgery	valuable
sycophant	servile
risk	worthwhile
directory	telephone
pavilion	promenade
surplus	squander
eulogy	praise
controversy	placate
elevation	pinnacle
cancer	malady
electricity	outlet
cacophony	opera
chemistry	element
fresco	painting
foreground	landscape
benefactor	fortune
mandate	ruler
diet	nutrient
monument	venerate
criminal	deviate
nunnery	convert
pharmacy	prescribe
stiletto	walk
unnecessary	prerequisites
nauseating	medicine
bloodthirsty	anemia
holistic	proof
adulterated	purity
fiery	flagrant
fervid	dispassionate
loquacious	talkative
gullible	naive
dissonant	discordant
waiver	safe
president	tyrannical
daredevil	audacious
novel	ingenuous
pedant	imaginative
obdurate	cooperative
ephemeral	fleeting
malleable	unchanging
vindictive	forgiving
equivocal	certain
betray	trust
philander	donate
waver	falter
deride	praise
corroborate	doubt
female	engender
artillery	bolster
catalyst	precipitate
exercise	enervate
adjudicator	mitigate
hindsight	perfect
alabaster	white
buoyancy	light
equilibrium	just
jubilation	biblical
homage	copy
grandeur	admire
duplicity	increase
depravity	corrupt
masonry	construct
leaf	autumnal
senator	dissentious
fluctuation	irregular
budget	austere
autopsy	fatal
autonomous	free
disparate	different
botanical	flowery
dormant	tired
unique	eccentric
inkling	pen
wheelchair	paraplegic
couch	lethargy
count	nobility
insurrection	government
latent	manifestation
impenetrable	defense
lacteal	milk
preponderant	thought
retrograde	direction
stringent	solid
subliminal	secret
reticent	talkative
jocular	humorous
haggard	old
dishevel	destroy
brutalize	attack
legalize	filibuster
predict	forecast
kill	massacre
