sect	religion
decanter	pour
concession	placate
pragmatism	philosophy
vitriol	spiteful
virulent	poisonous
castigate	criticize
playful	banter
embargo	commerce
pathogen	harmful
conceited	bumptious
clause	sentence
renegade	allegiance
sanguine	sickly
tripod	camera
cello	played
demented	lucidity
defendant	plaintiff
mud	opaque
assuage	mollify
memorable	unforgettable
antipathy	approval
bailiff	courthouse
pan	saute
kindling	combustible
print	lithograph
dermal	skin
atrocious	bad
exaggeration	caricature
tenable	indefensible
inchoate	experience
branch	bureaucracy
stock	inventory
estimate	approximate
heart	cardiac
inevitable	preventable
disingenuous	charlatan
authenticity	fraudulent
polish	shiny
flatter	rebuff
bombastic	turgid
lecher	salacious
eccentric	codger
legerdemain	deception
clean	immaculate
dilettante	dabble
hallucinogen	drug
subterfuge	deceive
abiding	ephemeral
expulsion	school
martinet	discipline
abolition	slavery
obdurate	stubborn
defame	venerate
control	irrepressible
farce	ridiculous
asphyxia	air
indulge	epicurean
immune	susceptible
demulcent	unguent
abominable	disagreeable
uncommon	outlier
beseech	request
candy	sweet
bird	fly
organized	neat
shark	fish
branch	tree
dead	life
shovel	dig
pilot	airplane
near	far
chess	game
win	lose
robin	bird
bees	hive
giant	large
hard	soft
map	guide
apple	heathy
salesman	sell
rare	common
carrot	vegetable
side	square
furious	angry
fin	fish
blanket	soft
rich	poor
obese	overweight
disorganized	order
brush	paint
mountain	tall
hockey	sport
teeth	chew
fork	eat
ecstatic	happy
steak	meat
nice	mean
exhausted	tired
shy	confidence
artist	paintbrush
letter	word
dog	pet
tuxedo	formal
pot	cook
cushion	sofa
jazz	music
ancient	old
boulder	heavy
mircroscope	examine
ice	slippery
depressed	sad
speakers	stereo
needle	sew
joy	emotion
dangerous	safe
lazy	ambition
potato	vegetable
scale	weight
ball	round
strange	normal
ignorant	knowledge
brilliant	intelligent
string	guitar
razor	shave
dry	moisture
theft	crime
milk	white
full	empty
pen	write
mattress	bed
clock	time
saturday	weekend
war	peace
combatant	fighter
infantile	immature
convict	guilty
rifle	gun
infinite	limited
perish	die
unskilled	expertise
ballad	song
clarify	obscure
bun	hamburger
charity	aid
traitor	treasonous
remember	predict
doughnut	pastry
examination	diagnosis
flamboyant	elaborate
taboo	acceptance
confirm	deny
salutation	letter
referee	officiate
professor	scholarly
beneficial	detrimental
bunch	bananas
granite	stone
hyperactive	energetic
witness	testimony
platter	serve
superstition	irrational
airplane	hangar
illiterate	read
cough	cold
contract	agreement
lizard	reptile
battle	war
treaty	peace
lenient	strict
blender	appliance
lantern	light
faded	brilliance
classroom	desk
dwindle	increase
ocean	immense
star	constellation
documentary	film
key	unlock
nearby	distant
whimper	fear
heart	organ
tidy	unkempt
gasoline	flammable
adolescent	maturity
boastful	proud
infection	bacteria
mask	disguise
passport	document
believable	credible
helium	gas
fish	gills
insecure	confidence
blaze	fire
antique	aged
article	magazine
lens	camera
appalled	dismayed
slob	messy
fever	symptom
advocate	criticize
christmas	gifts
boundless	limit
coal	fuel
fisherman	net
brake	decelerate
extrovert	gregarious
suspect	credibility
platform	policies
aimless	direction
marathon	endurance
emaciated	thin
infamy	reputation
jurisprudence	law
apathetic	zeal
avarice	generosity
bellicose	aggressive
rebuttal	refute
mutinous	compliant
rant	bombastic
castle	edifice
voluminous	large
negligence	carelessness
shepherd	dog
irrational	reason
senator	legislature
galleon	sail
misogynist	feminist
parishioner	church
insurgent	rebellious
epidermis	skin
quandary	uncertainty
colloquial	formal
spy	espionage
insomniac	sleep
volatile	unstable
clairvoyant	predict
dirge	mournful
bourgeoisie	class
menagerie	animals
bow	boat
miser	parsimonious
prosaic	exciting
infallible	error
vacuous	intelligence
partisan	biased
initial	acronym
meticulous	careful
ingenue	naive
hamlet	village
frivolous	grave
perceptive	notice
sophomoric	maturity
disparage	encourage
smorgasbord	foods
capillary	vessel
ignoramus	unintelligent
panacea	cure
maladroit	skill
fastidious	particular
exoneration	release
clay	malleable
pristine	damaged
fetter	restraint
map	atlas
diffident	confidence
agnostic	belief
palliative	relieve
exorcism	demons
grouch	cantakerous
incipient	mature
succulent	rich
caucus	meeting
indigent	poor
impromptu	rehearsal
maelstrom	storm
enigma	mysterious
veil	enshroud
poison	noxious
placid	tumultuous
blatant	obvious
blasphemy	religion
tawdry	taste
tedium	excitement
cringe	discomfort
diatribe	speech
buttress	wall
jury	deliberate
saccharine	sweet
altruism	selfishness
bishop	ordained
pragmatic	practical
cauldron	pot
precept	guidance
trinket	value
euphemism	polite
frail	brawn
acrophobia	heights
heretic	unorthodox
debunk	verify
legend	map
epistle	letter
detective	mysteries
thwart	frustrate
decoy	deceive
larceny	crime
coffee	bitter
alarm	warn
soda	beverage
clock	time
deck	ship
help	hinder
apple	tree
shell	nut
carefree	worry
huge	large
torch	illuminate
jewel	shiny
wedding	ceremony
gallery	art
violinist	orchestra
foot	inches
bright	dull
apathetic	motivation
loathe	dislike
root	plant
orphan	parents
mirror	reflect
cloth	threads
tattoo	permanent
outdated	modern
adorable	cute
sculpture	art
order	chaos
reckless	caution
fork	utensil
general	army
helmet	protect
bachelor	wife
gigantic	large
pain	discomfort
mansion	large
bald	hairy
sword	weapon
stage	theater
ruby	gem
building	manmade
insecure	confidence
ingredient	recipe
nightmare	dream
scientist	laboratory
hilarious	funny
surgeon	doctor
siren	alert
ruthless	pity
mandatory	optional
house	shelter
strange	familiar
room	house
silk	smooth
plant	garden
trip	fall
mechanic	cars
cotton	cloth
criminal	innocence
priceless	valuable
rooster	chicken
policeman	enforce
full	empty
novel	fictional
daffodil	plant
unique	uncommon
bread	bakery
democracy	government
extravagant	modesty
hand	clock
fresco	painting
foreground	landscape
benefactor	fortune
mandate	ruler
diet	nutrient
monument	venerate
criminal	deviate
nunnery	convert
pharmacy	proscribe
stiletto	walk
woman	engender
gun	bolster
catalyst	precipitate
workout	enervate
lawyer	mitigate
elevation	pinnacle
envy	sin
electricity	outlet
cacophony	opera
chemistry	element
hindsight	perfect
alabaster	white
buoyancy	light
equilibrium	just
jubilation	biblical
autonomous	free
disparate	distinct
botanical	flowery
dormant	tired
unique	eccentric
dishevel	destroy
brutalize	bully
legalize	filibuster
predict	forecast
kill	massacre
symbolic	metaphor
filthy	lucre
questionable	interrogation
maternal	parenthood
cancerous	growth
treaty	war
sunscreen	radiation
chauffeur	travel
muscle	motion
vaccination	infection
patron	sexist
record	tarnished
saint	benevolent
tumor	benign
madman	angry
rural	suburban
tangible	corporeal
dubious	suspicious
devoted	zealous
elementary	young
termite	wood
alcoholic	tavern
drug	stimulant
garnish	parsley
lens	projector
atheist	faith
turncoat	clothing
bigamist	wives
monk	contemplation
torpedo	explosion
hazardous	dangerous
preventable	foreseeable
altruistic	egoistic
avaricious	greedy
feeble	fruitless
frame	painting
television	screen
roof	edifice
butcher	meat
easel	canvas
tractor	pulled
bomb	detonated
scientist	discovered
city	populated
restaurant	eaten
boorish	propriety
prodigal	sons
acrobatic	flexibility
sanguine	blood
realistic	optimism
predator	ecosystem
talent	prodigy
victim	assailant
juror	prosecutor
builder	architect
usury	interested
jewelry	ostentatious
socialism	destructive
torture	cruel
ham	kosher
abstain	indulge
hypothesize	prove
desiccate	dehydrate
curse	ghostwrite
condemn	neglect
capricious	restrained
pleasing	breathtaking
offensive	stereotypical
objectified	purchased
insignificant	irrelevant
asphyxiation	choking
crochet	knitting
incredulity	faith
infection	contamination
excrement	waste
tournament	stadium
priest	synagogue
ambulance	paramedic
greyhound	racetrack
majordomo	estate
measurement	weigh
cheese	grate
newspaper	edit
pestle	grind
informant	educate
lava	molten
bleach	white
faith	blind
patriotism	militaristic
obesity	large
koala	marsupial
raindrop	torrent
accordion	polka
ballet	tango
pathogen	virus
idyllic	dreams
aquatic	water
political	democracy
scientific	medicine
diverse	cultures
beneficent	upset
magnanimous	generous
mellifluous	smooth
common	banal
aggressive	bellicose
legitimacy	scam
Satanism	prophet
blitheness	funeral
authenticity	imitation
brevity	epigram
unique	unprecedented
dire	pressing
bleak	desolate
theoretical	concrete
recondite	scholarly
vivacious	health
ignorant	belief
feminine	hormones
irreverent	respect
prudish	desire
picnic	basket
denouement	plot
album	photograph
abbey	cathedral
impresario	hostess
celebrity	questionnaire
antique	appraisal
negotiation	bazaar
trial	interrogation
population	census
narcissist	egocentric
canoe	rapid
businessman	perspicacious
child	legitimate
heiress	coddled
teenager	neonatal
piano	Italian
tree	arboreal
syringe	medical
electricity	static
humorous	amusing
unintelligible	illegible
plausible	impossible
declasse	rude
racist	prejudiced
padded	resume
hardwood	floor
cooperative	rival
somnambulant	nightmare
indigent	mendicant
simplicity	complex
importance	instrumental
worth	priceless
thirst	parched
meaning	purposeful
procure	valuable
insulate	warm
reject	commonplace
sand	rough
varnish	colorless
stigmatize	criticize
implicate	involve
horrify	concern
abstain	refrain
entice	repulse
whimsical	capricious
maligned	beneficent
experienced	inchoate
robust	disillusioned
intelligent	ingenuous
conjecture	supposed
anomaly	explicable
mosaic	ruined
pastry	bitter
rabbi	foreign
evil	courtesan
admirable	hero
generous	pedant
powerful	supplicant
spicy	marinade
ornament	tree
lemonade	glass
television	screen
demolition	implosion
alcoholism	addiction
cheap	inexpensive
unadorned	austere
conscious	asleep
mysterious	enigmatic
isolated	desolate
heretic	blaspheme
teetotaler	imbibe
sycophant	dominate
dowager	remarry
charlatan	divulge
dance	polka
nightmare	dream
stocking	skirt
banjo	guitar
aircraft	helicopter
smoke	burn
allegory	recant
pedant	walk
cloak	conceal
prosecutor	judge
mawkish	stoic
spineless	timorous
frightened	petrified
listless	jejune
speechless	deaf
ostracism	society
reluctance	hesitation
rebuttal	debate
gravity	orbit
exeunt	drama
libertine	freedom
fundamentalist	religion
ballerina	nutrition
cynic	optimism
sculptor	clay
choreography	dance
anarchism	government
vegetarianism	food
capitalism	money
conservation	trees
ironic	metallic
happy	felicitous
improbable	impossible
aforementioned	appropriate
lethargic	sluggish
elucidate	clarify
dismay	embolden
defend	barricade
daze	confuse
haggle	negotiate
penetrate	impermeable
mend	replaceable
sell	profitable
damage	decimated
see	visible
swallow	migratory
child	incorrigible
skewer	poignant
intersection	perpendicular
porcupine	avian
cancer	tumors
obesity	fat
anemia	iron
anorexia	disorder
depression	anxiety
complain	ravenous
revenge	vindictive
retract	revocable
startle	frightening
appreciate	deprecatory
corpulent	thin
audacious	bold
loquacious	babbling
laudable	praiseworthy
oblivious	distracted
concertina	instrument
oratorio	rhetoric
denizen	denomination
artisan	freemason
paroxysm	hysteria
lovable	annoying
dry	desiccated
dismal	lugubrious
penultimate	final
precipitous	steep
tentative	agenda
literary	synopsis
parsimonious	spendthrift
lethal	overdose
saccharine	diabetic
elucidate	clarify
excite	pique
search	discover
scrutinize	observe
truncate	shorten
water	cold
time	fast
money	clean
fire	hot
horse	ride
tree	run
fish	swim
arm	dance
ugly	pretty
fun	good
disgusting	sour
transparent	clear
sausage	vegetable
tulip	flower
aunt	uncle
mouse	rat
lemon	fruit
leg	chair
plant	flower
road	car
cold	temperature
perfect	error
loud	noise
yellow	color
bus	run
pencil	write
hat	protect
fork	take
driver	ship
conductor	train
bicycle	car
passenger	bus
gray	black
right	wrong
cold	freezing
good	fun
checkers	basketball
kid	child
man	woman
tennis	sport
play	learn
buy	sell
see	hear
like	love
pear	fruit
cucumber	onion
cow	calf
lamp	table
cows	city
birds	nest
snakes	house
bears	hotel
scary	bad
new	expensive
great	good
funny	annoying
fast	quick
smooth	straight
heavy	light
healthy	good
apartment	locate
bag	open
bed	read
towel	dry
teacher	good
bed	comfortable
car	fast
rock	hard
teacher	learn
mechanic	repair
lawyer	free
desk	hard
shiny	bright
fake	phony
old	new
thin	skinny
animal	horse
flute	instrument
fruit	apple
book	novel
finger	hand
hat	suit
bird	tree
pencil	paper
sad	happy
cold	cool
crazy	entertaining
terrified	afraid
string	guitar
nose	bird
tail	human
pickle	sandwich
money	rich
teacher	good
apple	ripe
circle	round
young	old
smart	tired
tall	angry
fun	nice
guilty	wrong
funny	clever
hideous	ugly
rude	mean
intelligent	belief
heavy	power
insignificant	importance
delicious	flavor
straw	drink
eraser	write
table	sit
key	turn
game	fun
ring	expensive
car	fast
rainbow	colorful
bus	car
rice	hunger
fight	war
chemistry	science
clouds	fly
hands	run
cats	scratch
legs	walk
calculator	think
phone	touch
flashlight	see
computer	drink
depressed	sad
thick	thin
terrible	easy
amazing	poor
nature	wood
water	food
transportation	street
anger	emotion
bad	happy
crazy	funny
sad	happy
healthy	fun
ready	lazy
excited	boring
sweet	mean
starving	hungry
smart	sense
hard	difficulty
cowardly	bravery
young	manners
lawyer	computer
dentist	teeth
teacher	apple
magician	wand
brick	house
hat	suit
toe	foot
phone	room
fire	water
cup	drink
drill	tool
car	bus
car	fast
king	smart
ring	plain
diamond	hard
camera	take
broom	sweep
rock	play
piano	sing
faucet	sink
toilet	kitchen
necklace	dress
dollar	wallet
silver	metal
window	glass
water	pool
juice	fruit
crazy	unhealthy
delicious	tasty
smart	intelligent
ring	beautiful
steak	good
beach	sunny
mountain	tall
letter	communicate
sweater	knit
ball	hit
game	score
basketball	fun
cake	delicious
paper	thin
chalk	white
peaceful	bored
sweet	strong
ready	anxious
elated	happy
arms	legs
feet	toes
wings	airplane
clouds	sky
movie	entertain
pencil	study
wheel	move
plate	drink
food	beverage
air	water
pain	feeling
money	product
hard	nice
easy	difficult
strong	thin
organized	orderly
bald	hair
strong	confidence
thirsty	food
rich	wealth
fish	shark
peach	fruit
bus	car
play	actress
thermometer	temperature
ruler	time
compass	location
calculator	money
dog	friendly
computer	expensive
feather	light
car	blue
scared	angry
unhappy	sad
nervous	young
new	old
scared	courage
old	health
nice	power
crazy	happiness
devastated	disappointed
talented	skilled
bored	intrigued
motivated	dedicated
shoe	pants
wheel	bicycle
candle	table
picture	wall
hair	comb
knife	cut
boat	drive
fork	drink
light	height
cold	warmth
healthy	meat
happy	weakness
winter	season
glass	window
chicken	beverage
air	cloud
traffic	heavy
science	boring
candy	good
honey	sticky
boring	exciting
sweet	tasty
loud	intense
new	young
shovel	dig
spoon	drink
bath	shower
door	open
drain	sink
chair	table
television	computer
lamp	light
building	height
ruler	length
pool	depth
sun	light
November	December
Wednesday	night
today	afternoon
January	winter
weather	clouds
math	fun
joy	sadness
socks	warmth
queen	monarch
palace	hut
horse	carriage
knife	sword
outstanding	impressive
plain	ordinary
absurd	hilarious
unwise	clever
clock	digital
rainforest	lush
film	lengthy
parachute	heavy
van	automobile
sin	blessing
memory	prediction
trombone	orchestra
valid	illegitimate
restored	renewed
destroyed	ruined
beloved	admired
ignore	oversee
fabricate	lie
inspire	insult
clarify	muddle
vivacious	intensity
apathetic	knowledge
tacky	taste
retired	enjoyment
burial	death
party	politician
meal	restaurant
mammal	animal
guard	protect
instruct	educate
acquire	dispose
hike	climb
ketchup	hotdog
windshield	car
theater	script
laugh	joke
dictionary	words
fortune	money
counselor	advice
translator	language
reporter	biased
hero	fictional
alligator	angry
crime	illegal
hear	listen
scrutinize	ignore
repeat	copy
interrogate	question
passport	document
stamp	currency
symphony	opera
volcano	lava
evaluation	title
inference	consequences
search	rescue
minute	hour
kind	benevolent
autocratic	democratic
ludicrous	absurd
desirable	necessary
factual	opinion
inspirational	reality
unpopular	support
independent	structure
use	employ
define	prove
dispense	collect
entertain	amuse
courtship	marriage
summit	mountain
book	character
composition	notebook
sentry	guard
grandmother	age
detective	accuse
wizard	curse
friend	imaginary
mystery	obvious
sorcerer	magical
father	maternal
allowed	forbidden
noteworthy	important
original	unique
faithful	dedicated
street	neighborhoods
vine	oranges
herd	cows
club	wolves
action	event
opera	song
culture	history
bleach	chemical
fabulous	drab
superficial	genuine
wealthy	greedy
gullible	trusting
spouse	marriage
judge	laws
waterfall	rivers
generator	electricity
fork	dice
spice	flavor
nose	scent
oven	boil
opinion	factual
purse	expensive
reward	motivational
invention	successful
car	garage
bus	stop
boat	lake
ship	ocean
immobile	move
excited	cheer
bored	concentrate
correct	falsify
fever	issue
problem	solution
disagreement	dispute
room	hotel
limerick	poem
human	monster
scarf	jewelry
dog	feline
ambulance	hospital
fight	argument
painting	sketch
crystal	mineral
button	hole
friend	companion
handle	shovel
lighthouse	coast
title	ownership
license	traffic
declaration	independence
dictionary	language
hopeful	optimistic
punctual	late
sentimental	emotional
irrational	inexplicable
tent	cabin
letter	symbol
chemical	biology
fungus	mushroom
fan	oxygen
toilet	waste
curtain	privacy
television	electricity
decrepit	strength
contemporary	modernity
downtrodden	sadness
troubled	danger
bank	dollar
church	pew
studio	paintbrush
museum	artifact
ridicule	mock
denounce	embrace
celebrate	congratulate
sting	stab
surface	flat
career	fulfilling
enemy	adversarial
quilt	detailed
crystal	jewel
reservation	table
bank	fortune
wick	candle
parka	sweater
hut	dwelling
debt	fee
chair	sofa
newspaper	guide
clothespin	hang
teacher	study
mortgage	bankrupt
timid	bold
classy	mannered
permanent	eternal
criminal	illegal
grimace	comfort
shrug	uncertainty
speech	language
receipt	price
glaze	sauce
spacecraft	rocket
octagon	shape
hero	doctor
smooth	jagged
moral	judgmental
finite	limited
intended	declared
love	wonderful
radiation	toxic
justice	arbitrary
religion	strict
murder	motive
suitcase	wheels
idea	clarity
lunatic	sanity
angry	outraged
impeccable	clean
ridiculous	humorous
skeptical	doubtful
intoxication	alcohol
glitter	shine
worth	money
rain	fog
powder	moisten
perfume	scent
shield	attack
daughter	marry
mineral	geology
clock	watch
fossil	artifact
notebook	literature
chilly	freezing
horrible	monstrous
visible	obvious
eternal	endless
Christianity	religion
truth	knowledge
courage	bravery
polarity	magnet
pig	hooves
human	lungs
whale	tails
eagle	talons
fluent	language
powerful	ability
modest	grace
indecisive	resolution
decision	idea
lighthouse	lamp
warlord	soldier
tournament	game
technique	effective
microphone	loud
grandfather	deceased
sphere	round
revolution	war
hood	jacket
speech	meeting
trigger	gun
amplifier	violin
keyboard	television
bank	vault
lobby	hotel
interested	apathetic
incomprehensible	illegible
overjoyed	happy
aloof	untouchable
benefactor	poor
miser	stingy
godmother	magical
researcher	intuitive
debate	argument
newspaper	magazine
fable	story
device	strategy
excuse	permit
conquer	liberate
enjoy	satisfy
relinquish	give
Thanksgiving	turkey
summer	school
Halloween	candy
May	flowers
saintly	holiness
understandable	recognition
renewed	authenticity
unrivaled	equal
kidney	body
dictatorship	government
thought	feeling
partner	accomplice
teacher	professor
doctor	stethoscope
demon	soul
mother	child
nurse	operate
veil	conceal
commercial	purchase
gift	receive
jingoist	nationalistic
judge	deciduous
philanthropist	amorous
businessman	shrewd
dubious	discussion
conventional	novelty
controversial	evidence
mountainous	elevation
slaughterhouse	meat
congregation	churches
hierarchy	rulers
medley	songs
wary	trust
pathetic	dignity
lazy	health
silly	comedy
tournament	judges
examination	knowledge
revolution	ideology
disaster	piety
peripatetic	mobile
quarrelsome	agreeable
meticulous	careful
insubordinate	obedient
compassion	virtue
pain	agony
emancipation	proclamation
sediment	dirt
linguistics	language
botany	animals
literacy	letters
astrology	space
righteous	judgment
secular	belief
unapologetic	remorse
impressionable	youth
tenacity	determination
jeopardy	security
territorialism	land
retaliation	revenge
reputable	shady
aromatic	unscented
corporeal	imagined
irksome	annoying
convulsion	shudder
message	inform
emporium	purchase
henchman	lead
nebulous	distinct
heinous	awful
laborious	toilsome
nominal	trivial
recluse	friendly
bard	talkative
conflagration	disastrous
obelisk	mysterious
objective	task
profiteer	mercenary
subpoena	summons
trilogy	sequel
ravenous	hungry
separable	divisible
sinuous	straight
lustrous	golden
stone	lithograph
jubilation	anniversary
bigotry	friendship
admiration	reverence
marsupial	kangaroo
whelp	dragon
albatross	bird
hornet	bee
voluble	fluency
irreproachable	flaws
eclectic	versatility
nefarious	sin
palisade	resort
battleship	armada
predator	wolf
introvert	personality
masterpiece	create
quarantine	isolate
neurologist	think
nominee	vote
modicum	abundance
reflection	inversion
priory	convent
consequence	action
rant	soliloquy
lament	testimony
opera	aria
constituent	district
garrison	garrulous
rivalry	amicable
stereotype	oversimplified
voice	monotonous
hypotenuse	triangle
procedure	method
supplicant	lender
transmission	radio
treachery	forgiveness
crime	wrongdoing
coupon	redemption
government	triumvirate
unbecoming	improper
resilient	persistent
perpendicular	angled
intermittent	continuous
manufacturer	production
principal	tutelage
clergyman	divinity
warden	prisoners
punishment	penance
innuendo	interpretation
stoic	emotion
counterfeit	falsity
scholarly	erudite
persnickety	picky
entertaining	jovial
important	momentous
crustacean	swim
patron	support
prodigy	learn
savant	teach
tree	deciduous
degenerate	racist
lawyer	diplomatic
parody	amusing
commission	wage
mortgage	insurance
disciple	leader
smorgasbord	buffet
troupe	theaters
harem	concubines
vernacular	dictionaries
wardrobe	furniture
word	lexicon
compliment	friendship
seaman	battleship
henchman	villain
humanitarian	mortal
misanthrope	antagonistic
doctor	hospitable
mercenary	greedy
clandestine	overt
mendacious	untrue
militaristic	aggressive
nuanced	detailed
inebriated	sobriety
obstinate	acceptance
polytheistic	salvation
pusillanimous	fear
vapid	liveliness
quixotic	chivalry
requisite	necessity
entertaining	excitement
rivulet	powerful
spinster	unmarried
savage	classy
proletarian	socialist
homophone	definition
newspaper	perspective
stanza	poem
cornucopia	harvest
ascetic	frugal
knowledgeable	informative
malignant	cancerous
artificial	genuine
witness	judgmental
slur	pejorative
epitaph	deceased
feline	feminine
fallacy	lie
formula	milk
simile	comparison
pesticide	crop
astute	clever
pitiless	callous
sensitive	tactful
frugal	extravagant
apprehensive	doubt
maternal	coddle
versatile	adapt
guilty	resent
circumspect	attention
capricious	impulse
prudent	wisdom
venal	integrity
venerate	desecrate
diverge	distract
purloin	steal
defy	reject
anthology	passages
almanac	books
disparity	crimes
massacre	soldiers
concubine	spouse
tabernacle	sanctuary
pedestrian	sidewalk
vignette	theater
teacher	tenured
virtuoso	skilled
illness	terminal
hooligan	popular
condiment	eat
mallet	strike
paradox	contradict
charlatan	deceive
domineering	power
abject	poverty
pretentious	modesty
faithful	commitment
fanatical	enthusiastic
edible	delicious
adamant	opposed
manipulative	masterful
examination	accusation
death	execution
governor	pardon
conviction	sentencing
profanity	censored
acceleration	quick
animosity	unwarranted
chicanery	dishonest
ruined	annihilated
didactic	instructive
inconspicuous	stealthy
paramount	unimportant
dichotomy	division
school	seminary
parasite	assistant
follicle	hair
appendage	body
reprimand	insult
typhoon	hurricane
beast	creature
infertile	family
incorrigible	punishment
rash	audacity
deceitful	honesty
lummox	grace
reputation	notoriety
predecessor	origin
tyrant	prerogative
predicament	solve
tonic	dissolve
deterrent	dissuade
correspondent	sanction
putsch	government
sin	evil
nation	expatriates
cave	stalagmites
conspiracy	successful
magnate	magnanimous
building	ramshackle
palace	ornate
prescient	correct
analogous	comparable
destitute	affluent
unctuous	oily
caustic	relaxing
amiable	indifferent
bloodthirsty	violent
farcical	funny
chef	entree
dissertation	degree
paleontologist	scientist
salute	capitulation
ethereal	concrete
apathetic	depressed
inadvertent	presaged
sanctimonious	hypocritical
precocious	direction
perpetual	cessation
impious	dedication
truant	membership
feline	cat
analgesic	painkiller
omen	destiny
savant	disability
bigot	prejudiced
beetle	venomous
politician	obtuse
professor	glib
beautician	paint
lampoon	mock
laureate	preside
flare	locate
performance	stellar
satellite	worldly
maze	labyrinthine
wavelength	shallow
coveted	desired
reviled	despised
tangential	irrelevant
credible	dubious
preeminent	important
legendary	unbelievable
novel	obsolete
powerful	dominant
fornication	marriage
treason	state
lethargy	energy
avarice	currency
vicious	wrath
bourgeois	wealth
haughty	humility
paraplegic	legs
revision	edition
honor	prestige
mortgage	debt
resignation	denial
nod	acquiescence
handshake	discrimination
haiku	poetry
hyperbole	literature
deal	hustle
nuance	pattern
laceration	injury
plaintiff	defendant
precinct	city
philanthropist	charity
cream	lotion
document	preamble
candidate	deprecate
precedent	preside
ruse	illuminate
lobbyist	persuade
omniscient	omnipotent
lethargic	slovenly
sacrosanct	sacred
hypocritical	dissonant
alacrity	clarity
impartiality	bias
levity	flippancy
gravity	momentum
prince	opulent
transgression	acceptable
cliche	intrepid
loft	unattainable
irritating	pleasing
tenacious	faltering
opaque	translucent
trivial	negligible
vibration	perception
pictograph	symbol
favor	currency
luminary	phantasm
chord	music
footnote	connotation
alibi	defense
epilogue	introduction
sequoia	longevity
physician	medicine
fool	sagacity
grandmother	idiosyncrasy
prophet	rogue
metaphor	literal
expletive	vulgar
sonnet	renegade
humorous	wit
obtuse	intensity
disinterested	ennui
longwinded	brevity
claustrophobia	closets
homophobia	discrimination
agoraphobia	crowds
vertigo	balance
hero	folksy
braggart	boastful
javelin	underhanded
hiatus	eternal
revere	denigrate
besmirch	slander
cower	submit
pontificate	pronounce
continent	nation
page	tome
tirade	government
legion	family
decathlon	competition
multitude	feast
lounge	vacation
credo	church
theologian	cancer
sojourner	destiny
archaeologist	hieroglyphics
courier	packages
retain	burst
meditate	snooze
laud	praise
bristle	brush
landscape	surround
eulogy	kill
quartet	compose
bulwark	protect
bureaucracy	administration
astrology	religion
venom	flavoring
mythology	deity
meat	fried
glass	fragile
gas	cheap
silk	rough
map	navigate
dog	party
cup	pour
shirt	design
fish	ocean
dirt	ingredient
cereal	pancake
shrimp	seafood
guitar	music
calendar	date
ruler	speed
mother	family
sleeve	shirt
player	game
tail	human
year	month
hurry	delay
travel	fly
steal	take
smile	laugh
cow	field
wish	dream
pearl	clam
tooth	sandwich
pill	doctor
page	book
song	music
cat	house
upset	sadness
successful	money
enslaved	freedom
talented	wisdom
possible	easy
critical	important
likely	incredible
upsetting	offensive
stove	bake
vacuum	clean
car	run
phone	write
demon	evil
trick	magic
cat	lazy
mother	helpless
animal	dog
saint	nun
mountain	volcano
president	leader
library	books
kitchen	food
butcher	meat
mailbox	letters
referee	team
employee	company
judge	jury
friend	family
bathtub	gallons
meter	miles
pound	ounces
fork	spoons
obvious	clear
guilty	wrong
secret	hidden
ordinary	unusual
brilliant	ideas
active	technology
employed	money
lonesome	company
praise	enjoy
watch	observe
worship	admire
burn	scorch
blade	knife
pot	pan
microphone	radio
television	satellite
prisoner	freedom
doctor	patience
man	feelings
star	space
preacher	cook
telescope	magnify
nurse	smoke
lock	unlock
gun	bullets
guitar	drums
chain	links
star	planets
necklace	silver
boat	electric
phone	broken
marathon	long
beautiful	ugly
happy	glad
successful	rich
curious	smart
obvious	mysterious
unkind	happy
polite	common
tragic	sad
language	book
justice	jail
happiness	religion
weightlifting	exercise
unity	division
culture	feeling
family	tradition
anger	pride
silly	thought
doubtful	conviction
selfish	friends
shy	jewelry
jet	airplane
fact	idea
program	computer
mountain	plastic
queen	fortress
guide	expedition
dad	business
salesman	sail
bomb	destroy
storm	rain
parade	walk
dream	sleep
nomad	home
postman	job
computer	fire
building	wall
new	strange
little	small
funny	important
freezing	cold
carelessness	mistakes
ignorance	knowledge
laughter	jokes
food	nutrition
tree	free
suit	formal
car	safe
ladder	low
overweight	skinny
large	huge
strong	forceful
depressed	sad
father	brother
yacht	boat
salad	cake
color	art
march	belief
jacket	suit
fruit	apple
windmill	wind
baseball	basketball
concert	music
party	house
trophy	prize
bracelet	stylish
jacket	leather
school	strict
biography	nonfiction
disabled	worth
certain	doubt
unemployed	hope
elegant	sympathy
moral	story
chair	table
roof	house
map	plan
wrench	tool
want	need
friend	enemy
grade	school
librarian	bookstore
cashier	hotel
artist	studio
doctor	church
strange	weird
famished	hungry
uncomfortable	painful
familiar	trustworthy
soup	drink
lollipop	candy
animal	bear
house	hut
heart	love
flag	wave
truck	transport
stereo	receive
neutral	prejudice
challenged	rivals
gullible	truth
childish	speech
unwanted	discarded
destructive	creative
animated	happy
pure	clean
fire	heat
tire	wheels
mother	children
cow	meat
easy	simple
great	good
pretty	sour
sick	healthy
beach	shore
stem	flower
school	classroom
tree	leaf
sunset	early
night	dark
literature	fancy
television	funny
head	face
motorcycle	wheel
buckle	belt
idea	plan
spill	run
play	cry
exercise	sweat
order	enjoy
dentist	teeth
doctor	children
chef	vegetables
playwright	theaters
trust	pleasure
joy	emotion
rain	snow
music	piano
novice	experience
expert	humility
worker	employment
elegant	style
wonderful	good
temporary	eternal
distant	far
new	original
frog	tadpole
girl	human
bull	cow
whale	dolphin
politician	destroy
judge	uphold
mother	teach
television	inform
piercing	sharp
fancy	elegant
traditional	old
relaxing	stressful
pretzel	salty
cloud	gray
man	violent
nurse	polite
spider	insect
fortune	money
diamond	stone
planet	star
pleasant	enjoyable
spicy	powerful
bitter	delicious
disgusting	unpleasant
coffee	cafe
clothing	laundromat
medicine	church
money	supermarket
music	invention
hammer	tool
friendship	person
wine	grape
arrogant	money
bitter	remorse
disappointed	stress
unready	preparation
song	note
flag	pole
tea	cup
step	staircase
