1) FARCE : RIDICULOUSA) swallow : migratory
B) child : incorrigible
C) skewer : poignant
D) intersection : perpendicular 
E) porcupine : avian
a

2) ASPHYXIA : AIRA) cancer : tumors
B) obesity : fat
C) anemia : iron
D) anorexia : disorder 
E) depression : anxiety
c

3) INDULGE : EPICUREANA) complain : ravenous
B) revenge : vindictive
C) retract : revocable
D) startle : frightening
E) appreciate : deprecatory
b

4) IMMUNE : SUSCEPTIBLEA) corpulent : thin
B) audacious : bold
C) loquacious : babbling 
D) laudable : praiseworthy 
E) oblivious : distracted
a

5) DEMULCENT : UNGUENTA) concertina : instrument 
B) oratorio : rhetoric
C) denizen : denomination 
D) artisan : freemason
E) paroxysm : hysteria
a

6) ABOMINABLE : DISAGREEABLEA) lovable : annoying 
B) dry : desiccated
C) dismal : lugubrious 
D) penultimate : final 
E) precipitous : steep
e

7) UNCOMMON : OUTLIERA) tentative : agenda
B) literary : synopsis
C) parsimonious : spendthrift 
D) lethal : overdoseE) saccharine : diabetic
d

8) BESEECH : REQUESTA) elucidate : clarify 
B) excite : pique
C) search : discover 
D) scrutinize : observe 
E) truncate : shorten
d