1) CELLO : PLAYEDA) tractor : pulled
B) bomb : detonated
C) scientist : discovered 
D) city : populated
E) restaurant : eaten
b

2) DEMENTED : LUCIDITYA) boorish : propriety 
B) prodigal : sons
C) acrobatic : flexibility 
D) sanguine : blood
E) realistic : optimism
a

3) DEFENDANT : PLAINTIFFA) predator : ecosystem 
B) talent : prodigy
C) victim : assailant
D) juror : prosecutor
E) builder : architect
c

4) MUD : OPAQUEA) usury : interested
B) jewelry : ostentatious 
C) socialism : destructive 
D) torture : cruel
E) ham : kosher
c

5) ASSUAGE : MOLLIFYA) abstain : indulge
B) hypothesize : prove 
C) desiccate : dehydrate 
D) curse : ghostwrite
E) condemn : neglect
c

6) MEMORABLE : UNFORGETTABLEA) capricious : restrained 
B) pleasing : breathtaking 
C) offensive : stereotypical 
D) objectified : purchased 
E) insignificant : irrelevant
b

7) ANTIPATHY : APPROVALA) asphyxiation : choking
B) crochet : knitting
C) incredulity : faith
D) infection : contamination 
E) excrement : waste
c

8) BAILIFF : COURTHOUSEA) tournament : stadium 
B) priest : synagogue
C) ambulance : paramedic 
D) greyhound : racetrack 
E) majordomo : estate
e