1) PROFESSOR : SCHOLARLYA) friend : imaginary 
B) mystery : obvious 
C) sorcerer : magical 
D) father : maternal
c

2) BENEFICIAL : DETRIMENTALA) allowed : forbidden
B) noteworthy : important 
C) original : unique
D) faithful : dedicated
a

3) BUNCH : BANANASA) street : neighborhoods 
B) vine : oranges
C) herd : cowsD) club : wolves
c

4) GRANITE : STONE
A) action : event
B) opera : song
C) culture : history 
D) bleach : chemical
d

5) HYPERACTIVE : ENERGETICA) fabulous : drab
B) superficial : genuine 
C) wealthy : greedy
D) gullible : trusting
d

6) WITNESS : TESTIMONYA) spouse : marriage 
B) judge : lawsC) waterfall : rivers
D) generator : electricity
d

7) PLATTER : SERVEA) fork : dice 
B) spice : flavor 
C) nose : scent 
D) oven : boil
b

8) SUPERSTITION : IRRATIONALA) opinion : factual
B) purse : expensive
C) reward : motivational 
D) invention : successful
c

9) AIRPLANE : HANGARA) car : garage 
B) bus : stopC) boat : lake 
D) ship : ocean
a

10) ILLITERATE:READA) immobile : move
B) excited : cheer
C) bored : concentrate 
D) correct : falsify
a