1) STAR : CONSTELLATIONA) crystal : jewel
B) reservation : table 
C) bank : fortune
D) wick : candle
d

2) DOCUMENTARY : FILMA) parka : sweater 
B) hut : dwelling 
C) debt : fee
D) chair : sofa
b

3) KEY : UNLOCKA) newspaper : guide 
B) clothespin : hang 
C) teacher : studyD) mortgage : bankrupt
b

4) NEARBY : DISTANT
A) timid : bold
B) classy : mannered 
C) permanent : eternal 
D) criminal : illegal
a

5) WHIMPER : FEARA) grimace : comfort 
B) shrug : uncertainty 
C) speech : language 
D) receipt : price
b

6) HEART : ORGANA) glaze : sauce
B) spacecraft : rocketC) octagon : shape 
D) hero : doctor
c

7) TIDY : UNKEMPTA) smooth : jagged
B) moral : judgmental 
C) finite : limited
D) intended : declared
a

8) GASOLINE : FLAMMABLEA) love : wonderful 
B) radiation : toxic 
C) justice : arbitrary 
D) religion : strict
b

9) ADOLESCENT : MATURITYA) murder : motive 
B) suitcase : wheelsC) idea : clarity 
D) lunatic : sanity
d

10) BOASTFUL:PROUDA) angry : outraged
B) impeccable : clean
C) ridiculous : humorous 
D) skeptical : doubtful
b