1) CLAIRVOYANT : PREDICTA) crustacean : swim 
B) patron : support 
C) prodigy : learn
D) savant : teach
b

2) DIRGE : MOURNFULA) tree : deciduous
B) degenerate : racist 
C) lawyer : diplomatic 
D) parody : amusing
d

3) BOURGEOISIE : CLASSA) commission : wage 
B) mortgage : insurance 
C) disciple : leaderD) smorgasbord : buffet
d

4) MENAGERIE : ANIMALS
A) troupe : theaters
B) harem : concubines
C) vernacular : dictionaries 
D) wardrobe : furniture
b

5) BOW : BOATA) word : lexicon
B) compliment : friendship 
C) seaman : battleship
D) henchman : villain
a

6) MISER : PARSIMONIOUSA) humanitarian : mortal
B) misanthrope : antagonisticC) doctor : hospitable 
D) mercenary : greedy
b

7) PROSAIC : EXCITINGA) clandestine : overt
B) mendacious : untrue 
C) militaristic : aggressive 
D) nuanced : detailed
a

8) INFALLIBLE : ERRORA) inebriated : sobriety 
B) obstinate : acceptance 
C) polytheistic : salvation 
D) pusillanimous : fear
a

9) VACUOUS : INTELLIGENCEA) vapid : liveliness 
B) quixotic : chivalryC) requisite : necessity
D) entertaining : excitement
a

10) PARTISAN : BIASEDA) rivulet : powerful
B) spinster : unmarried 
C) savage : classy
D) proletarian : socialist
b