1) IGNORAMUS : UNINTELLIGENTA) teacher : tenured 
B) virtuoso : skilled 
C) illness : terminal 
D) hooligan : popular
b

2) PANACEA : CUREA) condiment : eat
B) mallet : strike
C) paradox : contradict 
D) charlatan : deceive
b

3) MALADROIT : SKILLA) domineering : power 
B) abject : poverty
C) pretentious : modestyD) faithful : commitment
c

4) FASTIDIOUS : PARTICULAR
A) fanatical : enthusiastic 
B) edible : delicious
C) adamant : opposed
D) manipulative : masterful
a

5) EXONERATION : RELEASEA) examination : accusation 
B) death : execution
C) governor : pardon
D) conviction : sentencing
d

6) CLAY : MALLEABLEA) profanity : censored 
B) acceleration : quickC) animosity : unwarranted 
D) chicanery : dishonest
d

7) PRISTINE : DAMAGEDA) ruined : annihilated
B) didactic : instructive
C) inconspicuous : stealthy 
D) paramount : unimportant
d

8) FETTER : RESTRAINTA) dichotomy : division 
B) school : seminary 
C) parasite : assistant 
D) follicle : hair
a

9) MAP : ATLASA) appendage : body 
B) reprimand : insultC) typhoon : hurricane 
D) beast : creature
a

10) DIFFIDENT : CONFIDENCEA) infertile : family
B) incorrigible : punishment 
C) rash : audacity
D) deceitful : honesty
d