1) FRAIL : BRAWNA) humorous : wit
B) obtuse : intensity
C) disinterested : ennui 
D) longwinded : brevity
d

2) ACROPHOBIA : HEIGHTSA) claustrophobia : closets
B) homophobia : discrimination 
C) agoraphobia : crowds
D) vertigo : balance
c

3) HERETIC : UNORTHODOXA) hero : folksy
B) braggart : boastful
C) javelin : underhandedD) hiatus : eternal
b

4) DEBUNK : VERIFY
A) revere : denigrate
B) besmirch : slander
C) cower : submit
D) pontificate : pronounce
a

5) LEGEND : MAPA) continent : nation 
B) page : tome
C) tirade : government 
D) legion : family
b

6) EPISTLE : LETTERA) decathlon : competition 
B) multitude : feastC) lounge : vacation 
D) credo : church
a

7) DETECTIVE : MYSTERIESA) theologian : cancer
B) sojourner : destiny
C) archaeologist : hieroglyphics 
D) courier : packages
c

8) THWART : FRUSTRATEA) retain : burst
B) meditate : snooze 
C) laud : praise
D) bristle : brush
c

9) DECOY : DECEIVEA) landscape : surround 
B) eulogy : killC) quartet : compose 
D) bulwark : protect
d

10) LARCENY : CRIME
A) bureaucracy : administration 
B) astrology : religion
C) venom : flavoring
D) mythology : deity
a