1) LENS : CAMERAA) amplifier : violin
B) keyboard : television 
C) bank : vault
D) lobby : hotel
d

2) APPALLED : DISMAYEDA) interested : apathetic
B) incomprehensible : illegible 
C) overjoyed : happy
D) aloof : untouchable
c

3) SLOB : MESSYA) benefactor : poor
B) miser : stingy
C) godmother : magicalD) researcher : intuitive
b

4) FEVER : SYMPTOM
A) debate : argument
B) newspaper : magazine 
C) fable : story
D) device : strategy
c

5) ADVOCATE : CRITICIZEA) excuse : permit 
B) conquer : liberate 
C) enjoy : satisfy
D) relinquish : give
b

6) CHRISTMAS : GIFTSA) Thanksgiving : turkey 
B) summer : schoolC) Halloween : candy 
D) May : flowers
c

7) BOUNDLESS : LIMITA) saintly : holiness
B) understandable : recognition 
C) renewed : authenticity
D) unrivaled : equal
d

8) COAL : FUELA) kidney : body
B) dictatorship : government 
C) thought : feeling
D) partner : accomplice
b

9) FISHERMAN : NETA) teacher : professor 
B) doctor : stethoscopeC) demon : soul 
D) mother : child
b

10) BRAKE:DECELERATEA) nurse : operate
B) veil : conceal
C) commercial : purchase 
D) gift : receive
b