1) COMBATANT : FIGHTERA) queen : monarch 
B) palace : hut
C) horse : carriage 
D) knife : sword
a

2) INFANTILE : IMMATUREA) outstanding : impressive 
B) plain : ordinary
C) absurd : hilarious
D) unwise : clever
a

3) CONVICT : GUILTYA) clock : digital 
B) rainforest : lush 
C) film : lengthyD) parachute : heavy
b

4) RIFLE : GUN
A) van : automobile
B) sin : blessing
C) memory : prediction 
D) trombone : orchestra
a

5) INFINITE : LIMITEDA) valid : illegitimate 
B) restored : renewed 
C) destroyed : ruined 
D) beloved : admired
a

6) PERISH : DIEA) ignore : oversee 
B) fabricate : lieC) inspire : insult 
D) clarify : muddle
b

7) UNSKILLED : EXPERTISEA) vivacious : intensity 
B) apathetic : knowledge 
C) tacky : taste
D) retired : enjoyment
b

8) BALLAD : SONGA) burial : death
B) party : politician 
C) meal : restaurant 
D) mammal : animal
d

9) CLARIFY : OBSCUREA) guard : protect 
B) instruct : educateC) acquire : dispose 
D) hike : climb
c

10) BUN:HAMBURGERA) ketchup : hotdog 
B) windshield : car 
C) theater : script 
D) laugh : joke
b