1) FURIOUS : ANGRYA) sad : happy
B) cold : cool
C) crazy : entertaining 
D) terrified : afraid
d

2) FIN : FISHA) string : guitar
B) nose : bird
C) tail : human
D) pickle : sandwich
a

3) BLANKET : SOFTA) money : rich
B) teacher : good
C) apple : ripeD) circle : round
d

4) RICH : POOR
A) young : old
B) smart : tired
C) tall : angry
D) fun : nice
a

5) OBESE : OVERWEIGHTA) guilty : wrong 
B) funny : clever 
C) hideous : ugly 
D) rude : mean   
c

6) DISORGANIZED : ORDERA) intelligent : belief 
B) heavy : powerC) insignificant : importance 
D) delicious : flavor
c

7) BRUSH : PAINTA) straw : drink 
B) eraser : write 
C) table : sit
D) key : turn
a

8) MOUNTAIN : TALLA) game : fun
B) ring : expensive 
C) car : fast
D) rainbow : colorful
d

9) HOCKEY : SPORTA) bus : car
B) rice : hungerC) fight : war
D) chemistry : science
d

10) TEETH : CHEW
A) clouds : fly 
B) hands : run 
C) cats : scratch 
D) legs : walk
d