1) INFECTION : BACTERIAA) intoxication : alcohol 
B) glitter : shine
C) worth : money
D) rain : fog
a

2) MASK : DISGUISEA) powder : moisten 
B) perfume : scent 
C) shield : attack
D) daughter : marry
b

3) PASSPORT : DOCUMENTA) mineral : geology 
B) clock : watch
C) fossil : artifactD) notebook : literature
c

4) BELIEVABLE : CREDIBLE
A) chilly : freezing
B) horrible : monstrous 
C) visible : obvious
D) eternal : endless
d

5) HELIUM : GASA) Christianity : religion 
B) truth : knowledge
C) courage : bravery
D) polarity : magnet
a

6) FISH : GILLSA) pig : hooves 
B) human : lungsC) whale : tails 
D) eagle : talons
b

7) INSECURE : CONFIDENCEA) fluent : language
B) powerful : ability
C) modest : grace
D) indecisive : resolution
d

8) BLAZE : FIREA) decision : idea
B) lighthouse : lamp 
C) warlord : soldier
D) tournament : game
c

9) ANTIQUE : AGEDA) technique : effective 
B) microphone : loudC) grandfather : deceased 
D) sphere : round
d

10) ARTICLE:MAGAZINEA) revolution : war 
B) hood : jacket
C) speech : meeting 
D) trigger : gun
d