1) RAZOR : SHAVEA) hair : comb 
B) knife : cut 
C) boat : drive 
D) fork : drink
b

2) DRY : MOISTUREA) light : height
B) cold : warmth
C) healthy : meat
D) happy : weakness
b

3) THEFT : CRIMEA) winter : season
B) glass : window
C) chicken : beverageD) air : cloud
a

4) MILK : WHITEA) traffic : heavy 
B) science : boring 
C) candy : good 
D) honey : sticky
d

5) FULL : EMPTYA) boring : exciting 
B) sweet : tasty
C) loud : intense 
D) new : young
a

6) PEN : WRITEA) shovel : dig 
B) spoon : drinkC) bath : shower 
D) door : open
a

7) MATTRESS : BEDA) drain : sink
B) chair : table
C) television : computer 
D) lamp : light
a

8) CLOCK : TIMEA) building : height 
B) ruler : length
C) pool : depth
D) sun : light
b

9) SATURDAY : WEEKENDA) November : DecemberB) Wednesday : night 
C) today : afternoon 
D) January : winter
d

10) WAR : PEACE
A) weather : clouds 
B) math : fun
C) joy : sadness
D) socks : warmth
c