1) LIZARD : REPTILE
A) ambulance : hospital 
B) fight : argument
C) painting : sketch
D) crystal : mineral
d

2) BATTLE : WAR
A) button : hole
B) friend : companion 
C) handle : shovel
D) lighthouse : coast
c

3) TREATY : PEACE
A) title : ownership
B) license : traffic
C) declaration : independence
D) dictionary : language
a

4) LENIENT : STRICT
A) hopeful : optimistic
B) punctual : late
C) sentimental : emotional 
D) irrational : inexplicable
b

5) BLENDER : APPLIANCE
A) tent : cabin
B) letter : symbol
C) chemical : biology 
D) fungus : mushroom
b

6) LANTERN : LIGHT
A) fan : oxygen 
B) toilet : waste
C) curtain : privacy
D) television : electricity
c

7) FADED : BRILLIANCE
A) decrepit : strength
B) contemporary : modernity 
C) downtrodden : sadness
D) troubled : danger
a

8) CLASSROOM : DESK
A) bank : dollar
B) church : pew
C) studio : paintbrush 
D) museum : artifact
b

9) DWINDLE : INCREASE
A) ridicule : mock
B) denounce : embrace
C) celebrate : congratulate 
D) sting : stab
b

10) OCEAN : IMMENSE
A) surface : flat
B) career : fulfilling
C) enemy : adversarial 
D) quilt : detailed
c