1) PLAYFUL : BANTERA) symbolic : metaphor
B) filthy : lucre
C) questionable : interrogation 
D) maternal : parenthood
E) cancerous : growth
a

2) EMBARGO : COMMERCEA) treaty : war
B) sunscreen : radiation 
C) chauffeur : travel
D) muscle : motion
E) vaccination : infection
e

3) PATHOGEN : HARMFULA) patron : sexist
B) record : tarnished 
C) saint : benevolent 
D) tumor : benign
E) madman : angry
c

4) CONCEITED : BUMPTIOUSA) rural : suburban
B) tangible : corporeal 
C) dubious : suspicious 
D) devoted : zealous 
E) elementary : young
d

5) CLAUSE : SENTENCEA) termite : wood 
B) alcoholic : tavern 
C) drug : stimulant 
D) garnish : parsley 
E) lens : projector
e

6) RENEGADE : ALLEGIANCEA) atheist : faith
B) turncoat : clothing
C) bigamist : wives
D) monk : contemplation 
E) torpedo : explosion
a

7) SANGUINE : SICKLYA) hazardous : dangerous
B) preventable : foreseeable 
C) altruistic : egoistic
D) avaricious : greedyE) feeble : fruitless
c

8) TRIPOD : CAMERAA) frame : painting 
B) television : screen 
C) roof : edifice
D) butcher : meat
E) easel : canvas
e