1) FLATTER : REBUFFA) stigmatize : criticize 
B) implicate : involve 
C) horrify : concern
D) abstain : refrain
E) entice : repulse
e

2) BOMBASTIC : TURGIDA) whimsical : capricious 
B) maligned : beneficent 
C) experienced : inchoate 
D) robust : disillusioned 
E) intelligent : ingenuous
a

3) LECHER : SALACIOUSA) conjecture : supposed 
B) anomaly : explicable 
C) mosaic : ruined
D) pastry : bitter
E) rabbi : foreign
a

4) ECCENTRIC : CODGERA) evil : courtesan
B) admirable : hero
C) generous : pedant 
D) powerful : supplicant 
E) spicy : marinade
b

5) LEGERDEMAIN : DECEPTIONA) ornament : tree
B) lemonade : glass
C) television : screen
D) demolition : implosion 
E) alcoholism : addiction
e

6) CLEAN : IMMACULATEA) cheap : inexpensive
B) unadorned : austere 
C) conscious : asleep
D) mysterious : enigmatic 
E) isolated : desolate
b

7) DILETTANTE : DABBLEA) heretic : blaspheme 
B) teetotaler : imbibe
C) sycophant : dominate 
D) dowager : remarryE) charlatan : divulge
a

8) HALLUCINOGEN : DRUGA) dance : polka
B) nightmare : dream 
C) stocking : skirt
D) banjo : guitar
E) aircraft : helicopter
b