1) SUBTERFUGE : DECEIVEA) smoke : burn
B) allegory : recant 
C) pedant : walk
D) cloak : conceal
E) prosecutor : judge
d

2) ABIDING : EPHEMERALA) mawkish : stoic
B) spineless : timorous 
C) frightened : petrified 
D) listless : jejune
E) speechless : deaf
a

3) EXPULSION : SCHOOLA) ostracism : society
B) reluctance : hesitation 
C) rebuttal : debate
D) gravity : orbit
E) exeunt : drama
a

4) MARTINET : DISCIPLINEA) libertine : freedom
B) fundamentalist : religion 
C) ballerina : nutrition
D) cynic : optimism
E) sculptor : clay
b

5) ABOLITION : SLAVERYA) choreography : dance 
B) anarchism : government 
C) vegetarianism : food
D) capitalism : money
E) conservation : trees
b

6) OBDURATE : STUBBORNA) ironic : metallic
B) happy : felicitous
C) improbable : impossible
D) aforementioned : appropriate 
E) lethargic : sluggish
e

7) DEFAME : VENERATEA) elucidate : clarify 
B) dismay : embolden 
C) defend : barricade 
D) daze : confuseE) haggle : negotiate
b

8) CONTROL : IRREPRESSIBLEA) penetrate : impermeable 
B) mend : replaceable
C) sell : profitable
D) damage : decimated
E) see : visible
a