1) FORK : EATA) calculator : think 
B) phone : touch
C) flashlight : see 
D) computer : drink
c

2) ECSTATIC : HAPPYA) depressed : sad 
B) thick : thin
C) terrible : easy 
D) amazing : poor
a

3) STEAK : MEATA) nature : wood
B) water : food
C) transportation : streetD) anger : emotion
d

4) NICE : MEAN
A) bad : happy
B) crazy : funny
C) sad : happy
D) healthy : fun
c

5) EXHAUSTED : TIREDA) ready : lazy
B) excited : boring 
C) sweet : mean
D) starving : hungry
d
   
6) SHY : CONFIDENCEA) smart : sense 
B) hard : difficultyC) cowardly : bravery 
D) young : manners
c

7) ARTIST : PAINTBRUSHA) lawyer : computer 
B) dentist : teeth
C) teacher : apple
D) magician : wand
d

8) LETTER : WORDA) brick : house 
B) hat : suit
C) toe : foot
D) phone : room
c

9) DOG : PETA) fire : water 
B) cup : drinkC) drill : tool 
D) car : bus
c

10) TUXEDO : FORMAL
A) car : fast
B) king : smart
C) ring : plain
D) diamond : hard
d