1) HOUSE : SHELTERA) fire : heat
B) tire : wheels
C) mother : children 
D) cow : meat
a

2) STRANGE : FAMILIARA) easy : simple 
B) great : good 
C) pretty : sour 
D) sick : healthy
d

3) ROOM : HOUSEA) beach : shore
B) stem : flower
C) school : classroomD) tree : leaf
b

4) SILK : SMOOTH
A) sunset : early
B) night : dark
C) literature : fancy 
D) television : funny
b

5) PLANT : GARDENA) head : face
B) motorcycle : wheel 
C) buckle : belt
D) idea : plan
c

6) TRIP : FALLA) spill : runB) play : cry
C) exercise : sweat 
D) order : enjoy
c

7) MECHANIC : CARSA) dentist : teeth
B) doctor : children
C) chef : vegetables
D) playwright : theaters
a

8) COTTON : CLOTHA) trust : pleasure 
B) joy : emotion 
C) rain : snow
D) music : piano
b

9) CRIMINAL : INNOCENCEA) novice : experience 
B) expert : humilityC) worker : employment 
D) elegant : style
a

10) PRICELESS : VALUABLEA) wonderful : good 
B) temporary : eternal 
C) distant : far
D) new : original
a