1) INITIAL : ACRONYMA) homophone : definition 
B) newspaper : perspective 
C) stanza : poem
D) cornucopia : harvest
c

2) METICULOUS : CAREFULA) ascetic : frugal
B) knowledgeable : informative 
C) malignant : cancerous
D) artificial : genuine
a

3) INGENUE : NAIVEA) witness : judgmental 
B) slur : pejorative
C) epitaph : deceasedD) feline : feminine
b

4) HAMLET : VILLAGE
A) fallacy : lie
B) formula : milk
C) simile : comparison 
D) pesticide : crop
c

5) FRIVOLOUS : GRAVEA) astute : clever
B) pitiless : callous
C) sensitive : tactful 
D) frugal : extravagant
d

6) PERCEPTIVE : NOTICEA) apprehensive : doubt 
B) maternal : coddleC) versatile : adapt 
D) guilty : resent
c

7) SOPHOMORIC : MATURITYA) circumspect : attention 
B) capricious : impulse
C) prudent : wisdom
D) venal : integrity
d

8) DISPARAGE : ENCOURAGEA) venerate : desecrate 
B) diverge : distract
C) purloin : steal
D) defy : reject
a

9) SMORGASBORD : FOODSA) anthology : passages 
B) almanac : booksC) disparity : crimes 
D) massacre : soldiers
a

10) CAPILLARY : VESSELA) concubine : spouse
B) tabernacle : sanctuary 
C) pedestrian : sidewalk 
D) vignette : theater
b