1) BELLICOSE : AGGRESSIVEA) reputable : shady
B) aromatic : unscented 
C) corporeal : imagined 
D) irksome : annoying
d

2) REBUTTAL : REFUTEA) convulsion : shudder 
B) message : inform
C) emporium : purchase 
D) henchman : lead
b

3) MUTINOUS : COMPLIANTA) nebulous : distinct 
B) heinous : awful
C) laborious : toilsomeD) nominal : trivial
a

4) RANT : BOMBASTICA) recluse : friendly
B) bard : talkative
C) conflagration : disastrous 
D) obelisk : mysterious
c

5) CASTLE : EDIFICEA) objective : task
B) profiteer : mercenary 
C) subpoena : summons 
D) trilogy : sequel
c

6) VOLUMINOUS : LARGEA) ravenous : hungry 
B) separable : divisibleC) sinuous : straight 
D) lustrous : golden
a

7) NEGLIGENCE : CARELESSNESSA) stone : lithograph
B) jubilation : anniversary 
C) bigotry : friendship
D) admiration : reverence
d

8) SHEPHERD : DOGA) marsupial : kangaroo 
B) whelp : dragon
C) albatross : bird
D) hornet : bee
c

9) IRRATIONAL : REASONA) voluble : fluency
B) irreproachable : flawsC) eclectic : versatility 
D) nefarious : sin
b

10) SENATOR : LEGISLATUREA) palisade : resort
B) battleship : armada 
C) predator : wolf
D) introvert : personality
b