1) GALLEON : SAILA) masterpiece : create 
B) quarantine : isolate 
C) neurologist : think 
D) nominee : vote
b

2) MISOGYNIST : FEMINISTA) modicum : abundance 
B) reflection : inversion 
C) priory : convent
D) consequence : action
a

3) PARISHIONER : CHURCHA) rant : soliloquy
B) lament : testimony 
C) opera : ariaD) constituent : district
d

4) INSURGENT : REBELLIOUSA) garrison : garrulous
B) rivalry : amicable
C) stereotype : oversimplified 
D) voice : monotonous
c

5) EPIDERMIS : SKINA) hypotenuse : triangle 
B) procedure : method 
C) supplicant : lender 
D) transmission : radio
a

6) QUANDARY : UNCERTAINTYA) treachery : forgivenessB) crime : wrongdoing
C) coupon : redemption
D) government : triumvirate
b

7) COLLOQUIAL : FORMALA) unbecoming : improper 
B) resilient : persistent
C) perpendicular : angled 
D) intermittent : continuous
d

8) SPY : ESPIONAGEA) manufacturer : production 
B) principal : tutelage
C) clergyman : divinity
D) warden : prisoners
a

9) INSOMNIAC : SLEEPA) punishment : penanceB) innuendo : interpretation 
C) stoic : emotion
D) counterfeit : falsity
c

10) VOLATILE : UNSTABLEA) scholarly : erudite
B) persnickety : picky
C) entertaining : jovial
D) important : momentous
b