1) EXTROVERT : GREGARIOUSA) jingoist : nationalistic
B) judge: deciduous
C) philanthropist : amorous 
D) businessman : shrewd
a

2) SUSPECT : CREDIBILITYA) dubious : discussion
B) conventional : novelty 
C) controversial : evidence 
D) mountainous : elevation
b

3) PLATFORM : POLICIESA) slaughterhouse : meat 
B) congregation : churches 
C) hierarchy : rulers
D) medley : songs
d

4) AIMLESS : DIRECTIONA) wary : trust
B) pathetic : dignity 
C) lazy : health
D) silly : comedy
a

5) MARATHON : ENDURANCEA) tournament : judges
B) examination : knowledge 
C) revolution : ideology
D) disaster : piety
b

6) EMACIATED : THINA) peripatetic : mobile
B) quarrelsome : agreeableC) meticulous : careful
D) insubordinate : obedient
c

7) INFAMY : REPUTATIONA) compassion : virtue
B) pain : agony
C) emancipation : proclamation 
D) sediment : dirt
a

8) JURISPRUDENCE : LAWA) linguistics : language 
B) botany : animals
C) literacy : letters
D) astrology : space
a

9) APATHETIC : ZEALA) righteous : judgment 
B) secular : beliefC) unapologetic : remorse 
D) impressionable : youth
c

10) AVARICE : GENEROSITYA) tenacity : determination 
B) jeopardy : security
C) territorialism : land
D) retaliation : revenge
b